16
16
################
##X  ########  #
###X   ####   X#
##X  #  ##    ##
##   #        X#
#     ##   S   #
# XX    #     X#
#X##XX  #     ##
## #X   #    ###
# W #  #    X###
#   #X#   X X###
#   ##   X   X##
#   #   X  #  X#
##       X   X##
####XX  X#X X###
################